А|а=f
Б|б=,|<
В|в=d
Г|г=u
Д|д=l
Е|е=t
Ё|ё=`|~
Ж|ж=;|:
З|з=p
И|и=b
Й|й=q
К|к=r
Л|л=k
М|м=v
Н|н=y
О|о=j
П|п=g
Р|р=h
С|с=c
Т|т=n
У|у=e
Ф|ф=a
Х|х=[|{
Ц|ц=w
Ч|ч=x
Ш|ш=i
Щ|щ=o
Ъ|ъ=]|}
Ы|ы=s
Ь|ь=m
Э|э='|"
Ю|ю=.
Я|я=z