А|а=a
Б|б=b
В|в=v
Г|г=g
Д|д=d
Е|е=e
Ё|ё=e|yo|io
Ж|ж=j|jh
З|з=z
И|и=i
Й|й=i|y
К|к=k|ck
Л|л=l
М|м=m
Н|н=n
О|о=o
П|п=p
Р|р=r
С|с=s
Т|т=t
У|у=u
Ф|ф=f
Х|х=h
Ц|ц=c|ts
Ч|ч=ch
Ш|ш=sh
Щ|щ=sh
Ъ|ъ=
Ы|ы=i
Ь|ь=
Э|э=e|a
Ю|ю=u|yu
Я|я=a|ya